###########
#sssssssss#
#.........#
#.sssssss.#
#...sttt..#
#ss.sF....#
#s..s.....#
#sKssz..@.#
###########