###
#P#
#@#
#.#
#.#
#.#
#.#
#.#
#.#
#.###############################
#...............................#
#...................M.......M...#
#...............M.......M......K#
#...................M.......M...#
#...............................#
#################################