###########
#F.......z#
#t....@...#
#K........#
###########