#############
#H.Hl.z.lHHK#
#..Hl...l...#
#.HHl...l.HH#
#...........#
#H.Hl...lHH.#
#H..l...lH..#
#HH.l.@.lHHH#
#############