.....######
.....     #
.....# ####
.....#    #
.....#### #
.....#    #############
.....# ####   #   #   #####################
.....#      #   #   #    #   #            #
.....################### # # # ########## #
.......................# # # #          # #
.......................# # # #########  # #
.......................# # #         #  # #
.......................# # # ####### #  # #
.......................# # # #     # #  # #
.......................# # # # ### # #  # #
.......................# # # #   #   #  # #
.......................# # ##### #####  # #
.......................# # #         #  # #
.......................# # # ############ #
.......................#   #             @#
.......................####################