############
#tFFF..K...#
#..........#
#..........#
#..........#
#.........z#
#.....######
#.....#/////
#.....#/////
#..@..#/////
#######/////