###########
#.........#
#.#######.#
#.#.....#.#
#.#.###.#.#
#.#.#z..#.#
#K#.#...#.#
###.#####.#
#@........#
###########
